The program list:

bindis - Binomial Distribution
circleeq - Center, Radius and Equation of Cicle
combmeansd - Combined Mean and S.D.
cubic - Cubic Equation
datediff - Date Difference
deltatoy - Resistor Delta to Y Transformation
fib - Fibonacci Sequence
geodis - Geometric Distribution
heron - Heron's Formula
invstdnomdis - Inverse Standard Normal Distribution
matdet2 - 2x2 Matrix Determinant
matdet3 - 3x3 Matrix Determinant
matinv2 - 2x2 Matrix Inversion
matinv3 - 3x3 Matrix Inversion
matmul2 - 2x2 Matrix Multiplication
matmul3 - 3x3 Matrix Multiplication
podis - Poisson Distribution
polygonarea - Polygon Area by Sides and Angles
polygonarea2 - Polygon Area by Vertices
quad - Quadractic Equation
quadarea - Quadrateral Area
simlineq2 - System of 2 Linear Equations
simlineq3 - System of 3 Linear Equations
simlinquad - System of Linear & Quadratic Equation
stdnormdis - Standard Normal Distribution
tgtocircle - Tangent to Circle with given slope
vtrproduct - Dot and Cross Products
ytodelta - Resistor Y to Delta Transformation

Pending to Fix:
